011111100010000
000000001010110
011111110000100
000110101111110
110000000000000
000111101011110
011111101010110
000000001110000