000100010001000000000000010000010001000
011101010101011101011101011101010101111
000001010100010001010001000001000100000
111111011111010111010101111111111111110
000100010000000100010101000000000000010
011101110111111101110101111101011011010
000101000100010000000100000101010001010
110101010101010111110111110101010101010
000101010001010100000100000101000100010
011101011011011101111101011101111111010
000001000001000001010001000100000100010
010111011111111111010111110001011101110
000100000000000001010000010101000100000
010101111111111101010111010101110111111
000100000100010101010100010101000100000
110101110101010101010101010101011101011
010000000100010101000001010101000001000
011110111101010101111111110101111111110
000100000001000100000000000101000000010
010101011111111101111111010101011111010
010001010000000100000000000100010001010
010111010111110101110111111111110111010
000100010100010000010000000000010000010
110101110101010111011111111111010111110
000000000001010000000000010001000100000
011111011111011111010111010101111111011
010001000100010001000100000100000001000
010111110101110101011111110111111101010
000100010100000101000000010100000000000
110101010111111101011111011101011101010
000101000001000001000001000101000101000
111101111101110101111101010101110101010
000000000101000100010100010101000101000
011111010001010111010111010101011101110
010001010100000000010000010001010000000
010101010110110111111111110111011111110
010100010000010100000000010001000100000
010111111111010101101111011111110101111
000000000001000001000000000000000000000