000001000000000000000100000000000000000
111101011101011111110111110111110111110
000101000101000001010000010001000000010
011101010111111101011101011101011111010
000101010000010001010001010001000101010
010101011101010111010101010111010101010
010100000100010100010100010000010001010
110111110101110101010111111101011101010
000100000000010001000100000101010001010
010001010111010101010111010001010111011
010101010001000100000000010101010101000
011100011111011111111111110101010101110
000101000000000000010000010101010001000
010101110101011111010101000101011100011
010101000100010000010101010100010001000
010101011111110111110001110111011111110
000100010000000100010101000101010000000
011111010111111101010100011101010101101
010001010000000101000101010000010101000
010101011111110101110101011111110111010
000101010000010000000001010000000100000
011101010101011111011111010111111101110
000001010101000100010000010000000000010
011101011101110101110110111101111111010
000001000101000100000100000100010001010
010111110101011111111101110101110101010
000000010001010000000001010101000101010
010101111111011111011111010111011101110
010100000001000000010000010100010100000
010111110101111111110111110101110111110
000100000100000001000000000101000000000
011101110111011111011111111101011101111
010001000000000000010000000000000100000
010101111101110111110111011111110111110
010101000101000100000001010000000000010
110111010101011111010101110110111101010
000100010101010001000100000100010001000
011101110111010101110111101101110111111
000000010000000100000100000000000000000